R 1920 1080

NO ./textures/redbrick.xpm

SO ./textures/eagle.xpm

WE ./textures/greystone.xpm

EA ./textures/colorstone.xpm

S ./textures/star.xpm

F 224,172,105

C 205,249,255

11111111111111111111111111111
10000000001100000000000011111
10000000011100020002000011111
10000E00000000000000000011111
11111111101100000111002011111
10000000001100000111011111111
11110111111111011100000010001
11110111111111011101010010001
11000000110101011100000000001
10000000000000001100200010001
10000000000000001101110010001
11000001110101011111011110001
11110111111101111111111010001
11111111111111111111111111111